497;
50;
4160;
3040;
1004,860,947,1191,860,1082,1234,1330,799,462,465,548,484,484,597,853,1083,906,803,647,322,322,432,439,439,1873,2073,2198,2582,2638,2992,3656,3376,3445,3456,3010,1410,1710,2109,2633,2688,2961,3230,3302,3703,3696,3390,2902,2502,2147,1566,1473,1202,1166,1165,1170,1122,1381,1343,1577,1722,1722,1569,2148,1894,1878,2390,2230,1888,1609,1711,1711,2013,2435,2550,2822,3238,1330,2079,2256,2077,2121,2382,2297,2518,2297,2602,2902,485,927,1396,1225,720,1629,1913,1977,1892,1629,1679,2352,2389,1678,937,1226,937,1121,1036,2607,2608,2749,2856,3062,2749,2924,2925,3373,3630,3464,3642,1120,1004,1004,992,1122,1753,1566,1649,1576,1476,1477,1381,1165,1165,1874,2076,650,362,2,320,426,2,383,596,259,595,1333,1878,1334,1119,1121,1608,1607,855,855,595,855,484,262,484,547,719,259,362,536,413,800,1080,1120,802,83,621,2,253,1334,1381,1379,1262,1434,1803,3229,1803,2099,3265,3279,2350,2388,2607,2338,3314,3371,3195,3265,3208,2679,3646,4070,3228,3695,3383,3340,3995,3371,3465,3229,3702,4153,3987,3824,3790,3240,3694,3847,3239,3207,3578,3303,3191,3229,2823,2547,624,683,2013,1711,1873,2222,1873,2552,3154,610,3011,3575,3607,2393,2345,2195,2334,2500,2144,2692,2866,2899,2900,2602,3010,3157,3455,3440,3768,3749,2079,2120,2380,2819,3309,2298,991,1510,1754,801,2,2,2,373,2,609,113,2,2153,5,539,539,649,648,774,1678,529,2187,2577,2582,745,1515,1847,2146,2510,2995,2786,2956,2813,2503,2188,585,2580,3210,3307,3254,3109,3289,3054,3376,857,3655,3619,3614,3592,3461,3859,3373,3790,4013,3854,3893,2853,2853,2752,2747,1709,1975,1629,1680,1708,1381,145,1037,484,926,1225,1035,1119,937,937,778,244,762,238,110,2,546,2,800,1267,1336,1137,1119,3308,3209,3147,3147,3160,3319,3256,3149,3160,3239,3294,3242,3269,1935,2087,1988,1874,1879,2043,1263,2058,1964,1941,1949,1954,1972,2000,2082,2062,1940,1873,2006,2088,1874,1937,1879,2042,1886,3266,3217,3213,3139,3109,3110,3302,3295,3244,3174,3129,3263,3238,3202,3245,3227,3190,3174,3372,3339,3316,3352,3301,3281,3309,3176,3177,3129,3112,3110,3113,3218,3324,3247,3110,651,608,543,517,516,540,604,669,611,517,545,786,770,758,751,749,793,776,759,755,812,545,642,608,607,624,681,724,734,740,777,857,761,1234,1232,1077,1082,762,874,821,784,778,644,545,648,648,762,762,587,626,612,847,831,824,808,2228,2104,2038,2021,2022,2063,2229,2153,2114,2106,2228,2022,2021,2127,2211,2174,2144,2206,2165,2195,674,677,798,792,647,;
1919,1954,1978,2086,1954,437,268,3,463,481,479,946,1146,1147,1332,1398,1376,1713,2298,2543,2403,2403,2213,1792,1793,2217,2321,2503,2667,2331,2225,1983,2107,1900,1717,1685,480,366,275,343,327,453,319,577,417,747,854,1790,1904,1806,2223,1858,1866,1814,1814,1607,1483,1761,1650,1821,1981,1980,1606,1805,1609,1353,1592,1337,1203,1395,1066,1065,1000,864,1061,1152,1194,1452,2032,2040,2031,2213,2248,2421,2484,2422,1892,1789,708,628,656,824,842,576,449,670,793,575,744,344,628,743,1134,823,1134,1096,1281,619,619,837,554,781,838,773,772,549,671,639,439,2241,1919,1919,2092,2239,2222,2225,2003,1821,1859,1859,1762,1813,1813,2218,2321,2542,2510,2470,2402,2215,2472,1368,1332,625,1330,1451,1353,1451,1483,1484,1393,1393,1398,1396,1331,1297,1147,624,1145,948,842,626,402,392,363,463,437,2,462,171,450,4,241,7,266,261,4,2,2,320,2,269,866,812,344,629,618,345,860,548,952,866,1003,322,438,1333,318,747,882,836,767,548,639,319,415,2,729,961,1688,1190,744,974,1192,1002,908,785,1019,1019,1151,1061,1132,1113,1001,1066,1197,1335,1197,1352,1579,1167,1682,909,1318,1593,1658,1794,1823,1902,1807,1950,2101,1790,1790,1894,1683,1576,1716,1523,1688,1567,2033,2211,2249,2398,1046,2420,2092,2535,2218,2295,3035,2470,2472,2123,1794,1167,1662,1792,574,3034,2194,2194,2542,2245,2258,2586,3035,3037,2672,2669,2235,2767,2770,2806,2773,2226,2795,2775,2917,2934,3036,3014,2669,1957,2312,1855,2431,2583,2757,2109,1954,1983,2100,2264,2422,2590,2151,2110,1688,1634,1321,1134,554,553,839,841,694,675,576,743,694,271,1108,845,708,628,821,846,1097,1135,1136,1379,263,1298,528,702,2,1251,4,462,59,6,2,2,1948,1956,1964,1965,1892,1879,1854,1964,1893,2148,1982,1988,1998,1220,1371,1337,1190,1245,1313,3,1330,1283,1236,1254,1265,1304,1117,1087,1212,1157,1136,1214,1369,1198,1220,1244,1315,1211,864,931,1000,981,918,917,884,817,790,807,860,876,910,946,1004,1023,1019,989,801,836,860,767,785,810,860,806,804,861,921,921,920,931,1004,1005,919,2248,2278,2341,2269,2268,2192,2162,2169,2281,2273,2342,2238,2256,2265,2240,2241,2225,2220,2226,2268,2291,1252,1348,1167,1168,1130,1111,1121,1259,1220,1380,1295,1296,264,273,462,437,1297,1233,1211,1237,1379,1343,1253,1196,1195,1298,1298,1286,1271,1304,1312,1331,1327,1364,946,975,777,741,741,640,632,575,756,972,631,739,739,882,848,857,930,802,821,923,2275,2301,2255,2262,2294,;
1191,1003,992,1565,948,1233,1264,1381,1081,801,486,719,549,597,854,1083,1121,1171,992,803,648,432,615,616,905,2073,2198,2581,2637,2992,3376,3790,3445,3656,3789,3456,1710,2109,2352,2690,2962,3230,3303,3373,3857,3858,3696,3009,2601,2502,1649,1650,1473,1201,1382,1344,1333,1578,1569,1777,1752,1778,1894,2392,2076,2076,2552,2551,2230,1878,1889,2015,2434,2550,2821,3237,3391,1610,2257,2459,2120,2381,2460,2546,2547,2519,2911,2911,926,1395,1431,1432,1037,1913,2089,2089,1977,1707,1708,2390,2621,1892,1036,1337,1036,1337,1120,2633,2621,2856,3145,3145,2932,2933,3061,3465,3644,3630,3702,1282,1120,1120,1120,1283,1874,1650,1751,1777,1651,1578,1477,1381,1200,2077,2197,1566,647,364,374,618,373,484,903,483,905,1562,2074,1609,1565,1168,1877,1896,1121,1120,855,892,597,485,547,718,1043,484,488,600,491,1080,1232,1264,1126,178,696,469,414,1381,1439,1410,1337,1802,2109,4152,4156,2348,3307,3304,2607,2606,2620,2633,3396,3647,3208,3307,3214,2961,3699,4128,3302,3855,3424,3385,4094,3465,3628,3701,3859,4158,4132,3905,4155,3694,4153,4010,3392,3229,3769,3350,3229,3273,3237,2824,741,726,2434,2013,2547,2554,2548,3010,3771,741,3154,4157,3750,2601,2395,2219,2460,2601,2502,2785,2900,2913,3011,2902,3455,3455,3791,3588,3792,3919,2255,2255,2458,2914,3325,2545,1121,1521,2195,1566,648,650,319,430,268,651,233,445,2228,528,727,603,1565,776,828,1805,2193,2582,3305,2637,779,1634,1999,2325,2604,3375,2811,2994,2948,2656,2580,2184,4154,3308,3375,3365,3252,3402,3088,3656,1006,3790,3722,3724,3705,3563,3869,3655,4157,4016,4004,4011,3144,3062,2934,2926,1978,2085,1910,1892,1891,1410,248,1226,926,1394,1431,1399,1224,1036,1120,854,258,822,255,140,802,598,274,1079,1323,1442,1441,1266,3364,3240,3362,3160,3255,3362,3319,3363,3365,3361,3336,3267,3292,1988,2203,2087,1879,1953,2066,1716,2076,2137,2180,2160,2047,2114,2083,2145,2208,1989,1976,2223,2198,1936,1988,1952,2077,1932,3366,3326,3252,3214,3138,3130,3309,3309,3295,3244,3175,3266,3263,3238,3308,3273,3227,3191,3422,3385,3397,3398,3353,3305,3315,3243,3294,3292,3207,3266,3199,3265,3368,3310,3139,780,753,729,543,540,604,669,730,754,727,727,838,810,804,760,758,806,792,777,809,828,648,713,734,624,680,724,744,741,745,805,892,891,1264,1336,1232,1234,785,892,873,821,804,712,711,741,740,784,889,635,661,659,857,833,825,814,2246,2114,2288,2038,2064,2154,2286,2230,2245,2229,2284,2156,2039,2142,2223,2187,2156,2212,2174,2203,750,718,813,807,735,;
2085,1919,2093,2225,1977,268,2,272,438,464,709,842,944,1331,1397,1376,1484,1607,2092,2298,2545,2213,2049,2051,1714,2321,2502,2668,2331,2225,2107,1688,1898,1985,1690,1717,365,275,345,328,454,319,577,549,597,598,745,1686,1893,1904,2000,2002,1859,1867,1760,1650,1452,1822,1606,1728,2221,1729,1609,1593,1526,1525,1354,1355,1339,1354,1204,1000,863,1060,1151,1195,854,1396,2040,1971,2212,2250,1971,2256,2256,2485,2153,2152,628,656,765,766,849,449,447,447,670,694,693,627,747,794,848,1113,1280,1114,1097,343,747,555,506,507,982,982,782,639,440,672,417,2119,2239,2239,2239,2119,2218,2003,2223,1728,2003,1821,1860,1760,1865,2322,2505,2225,2545,2511,2123,2049,2125,1147,1711,707,1712,1604,1526,1396,1605,1604,1353,1608,1484,1484,1397,1398,1330,1146,948,842,848,709,420,410,371,438,267,6,2,254,465,482,228,267,3,478,5,3,274,2,3,343,856,785,618,618,746,346,781,437,1000,856,924,451,414,1325,575,600,847,880,783,639,670,416,599,606,722,897,1689,745,604,814,856,1021,1689,768,1023,974,1193,1154,1161,1121,862,1001,1061,1354,1059,1685,1690,1161,1575,602,1301,1892,1596,1752,1847,1891,1904,1997,2111,2152,1683,1791,1715,1715,1690,1519,1689,1540,2040,2041,1971,2455,1002,2259,2238,2647,2503,2225,2540,2542,2405,2213,622,1197,1536,1797,632,3035,2184,2163,2223,2342,2266,2604,2500,2669,2311,2332,2211,2756,2762,2787,2785,2108,2661,2632,2935,2920,2669,2572,3037,1946,2113,1946,2412,2419,2591,1983,1918,1691,2095,2255,2405,2578,2266,1981,1686,1493,1305,1136,507,782,982,771,675,446,451,793,793,480,1146,820,627,656,765,653,822,1279,1098,1396,187,1212,414,568,462,1331,640,461,55,2,3,7,2114,2155,1944,1893,1853,1946,1880,1945,1946,2111,2116,2092,2102,1337,1324,1369,1245,1257,1294,3,1313,1355,1334,1344,1305,1362,1195,1213,1249,1182,1209,1309,1328,1221,1338,1255,1314,1239,917,1006,956,1000,981,860,855,859,818,790,807,857,876,911,1047,969,1025,1020,844,882,780,781,767,781,862,790,817,816,999,869,950,869,917,1047,979,2344,2383,2183,2341,2192,2161,2168,2184,2380,2184,2184,2285,2293,2233,2226,2264,2235,2225,2220,2228,2266,1195,1243,1259,1131,1111,1121,1153,1220,1154,1296,1397,1298,5,6,270,267,1238,1299,1232,1212,1296,1241,1242,1222,1222,1239,1297,1234,1238,1267,1363,1354,1327,1320,732,760,723,776,640,573,726,635,734,928,722,574,776,779,774,790,851,750,758,871,2332,2330,2266,2275,2353,;
1,15,15,15,15,15,15,15,15,15,15,15,15,15,15,15,15,15,15,15,15,15,15,15,15,15,15,15,15,15,15,15,15,15,15,15,15,15,15,15,15,15,15,15,15,15,15,15,15,15,15,15,15,15,15,15,15,15,15,15,15,15,15,15,15,15,15,15,15,15,15,15,15,15,15,15,15,15,15,15,15,15,15,15,15,15,15,15,15,15,15,15,15,15,15,15,15,15,15,15,15,15,15,15,15,15,15,15,15,15,15,15,15,15,15,15,15,15,15,1191,1191,947,947,1567,15,1751,1722,1721,1721,1721,1578,1478,1480,1753,1751,807,320,319,429,442,442,443,442,484,1179,1120,1896,1564,1346,1347,1898,1564,1084,1168,1168,853,444,385,485,485,484,464,331,585,527,1123,1121,1234,2,188,638,267,398,1440,1708,1709,15,1707,1707,2686,2103,4154,3303,3315,2632,2351,2389,4153,3350,3220,3219,3292,3252,3229,3229,4081,3371,4157,3373,3374,4049,3646,3645,4153,4153,3852,4105,3862,4156,3579,3577,4084,3694,3253,3231,3316,3136,3253,3010,2228,680,747,2548,1879,2014,2821,2226,2822,3236,623,3237,3789,3668,2553,2387,2229,2411,2392,2392,2768,2828,2602,2554,2549,3156,3485,3486,3502,3579,3775,2120,2383,2256,2989,3274,2517,806,1621,648,1119,2191,4,374,442,454,743,234,3,2039,2191,669,667,1753,753,795,1732,2190,2193,2992,2994,808,1595,1948,2271,2550,3306,2862,3029,2880,2603,4154,2176,3307,3363,4152,3320,3225,3440,3192,3445,947,4155,3688,3696,3694,3546,4005,4154,4154,4112,4055,4009,3062,2926,2924,2856,1912,1913,1709,1709,1974,15,228,1119,1037,1034,1396,1224,1337,1119,1037,856,209,874,193,55,466,643,3,1082,1273,15,1313,15,15,15,15,15,15,15,15,3160,3254,3207,15,15,15,15,15,15,15,15,15,15,15,15,15,15,15,15,15,15,15,15,2393,2302,1930,1951,2088,1876,2062,1885,15,15,15,15,15,15,15,15,15,15,15,15,15,15,15,15,15,15,15,15,15,15,15,15,15,3296,3130,3110,3201,3292,3268,3327,3262,3273,3210,15,15,15,15,15,15,15,15,650,539,516,15,15,15,15,15,15,15,15,745,769,15,15,15,15,15,15,15,15,15,15,15,15,1338,1409,1409,1077,15,15,15,15,856,546,645,744,734,822,873,15,15,15,15,15,15,15,15,15,15,15,15,15,15,15,2230,2116,2039,2065,2155,15,15,15,15,15,15,15,15,15,15,15,15,;
1,15,15,15,15,15,15,17,15,15,15,15,15,15,15,15,15,15,15,15,15,15,15,15,15,15,15,15,15,15,15,15,15,15,15,15,15,15,15,15,15,15,15,15,15,15,15,15,15,15,15,15,15,15,15,15,15,15,15,15,15,15,15,15,15,15,15,15,15,15,15,15,15,15,15,15,15,15,15,15,15,15,15,15,15,15,15,15,15,15,15,15,15,15,15,15,15,15,15,15,15,15,15,15,15,15,15,15,15,15,15,15,15,15,15,15,15,15,15,2087,2087,1976,1976,2225,15,2221,1981,1982,1982,1982,1823,1859,1858,2221,2218,2293,2401,2402,2212,1795,1795,1792,1791,1149,1604,1484,1605,1606,1649,1649,1611,1606,1377,1604,1602,1397,1794,1369,710,708,708,481,429,365,311,2,2,270,3,169,395,626,341,2,366,366,15,366,365,325,271,3,882,859,345,344,629,2,767,311,932,817,953,317,319,1264,548,603,802,804,746,435,432,2,2,605,675,835,602,910,908,886,747,953,1192,859,920,953,1684,1333,1111,1167,1061,1195,1001,1153,1335,1151,1188,1132,1193,1689,1251,1354,1700,1788,1789,1594,1594,1939,2038,1891,1352,1347,1574,1615,1613,1426,910,1482,2212,2250,2040,2353,972,2482,2295,2584,2541,2236,2502,3036,2124,1793,1805,1159,1667,2472,778,2500,2167,2168,2220,2377,2236,2689,3037,2499,2225,2225,2230,2905,2861,2868,2862,2311,2757,2730,3037,3032,3037,2486,2309,2117,3037,1879,2468,2513,2674,1900,1976,3037,2156,2342,2471,2683,2190,3037,3036,1602,1437,1264,782,770,766,555,449,450,695,693,675,15,1022,1096,847,847,656,821,1113,1097,848,1295,183,1233,405,441,482,1342,1801,437,33,15,25,15,15,15,15,15,15,15,15,1893,1853,1953,15,15,15,15,15,15,15,15,15,17,15,15,15,15,15,15,15,15,15,15,1449,1149,1219,1257,1369,1198,1295,1236,15,15,15,15,15,15,15,15,15,15,15,15,15,15,15,15,15,15,15,15,15,15,15,15,15,820,861,920,946,815,869,1007,863,970,1000,15,15,15,15,15,15,15,15,2248,2193,2272,15,15,15,15,15,15,15,15,2235,2255,15,15,15,15,15,15,15,15,15,15,15,15,7,478,479,463,15,15,15,15,1295,1251,1199,1157,1260,1211,1232,15,15,15,15,15,15,15,15,15,15,15,15,15,15,15,930,756,779,637,574,15,15,15,15,15,15,15,15,15,15,15,15,;
0,0,0,0,0,0,0,0,0,0,0,0,0,0,0,0,0,0,0,0,0,0,0,0,0,0,0,0,0,0,0,0,0,0,0,0,0,0,0,0,0,0,0,0,0,0,0,0,0,0,0,0,0,0,0,0,0,0,0,0,0,0,0,0,0,0,0,0,0,0,0,0,0,0,0,0,0,0,0,0,0,0,0,0,0,0,0,0,0,0,0,0,0,0,0,0,0,0,0,0,0,0,0,0,0,0,0,0,0,0,0,0,0,0,0,0,0,0,0,1,1,1,1,1,0,1,1,1,1,1,1,1,1,1,1,1,1,1,1,1,1,1,1,1,1,1,1,1,1,1,1,1,1,1,1,1,1,1,1,1,1,1,1,1,1,1,1,1,1,1,1,1,1,1,1,1,1,1,1,1,1,1,1,1,1,1,1,1,1,1,1,1,1,1,1,1,1,1,1,1,1,1,1,1,1,1,1,1,1,1,1,1,1,1,1,1,1,1,1,1,1,1,1,1,1,1,1,1,1,1,1,1,1,1,1,1,1,1,1,1,1,1,1,1,1,1,1,1,1,1,1,1,1,1,1,1,1,1,1,1,1,1,1,1,1,1,1,1,1,1,1,1,1,1,1,1,1,1,1,1,1,1,1,1,1,1,1,1,1,1,1,1,1,1,1,1,1,1,1,1,1,1,1,1,1,1,1,1,1,1,1,1,1,1,1,1,1,1,1,1,1,0,1,1,1,1,1,1,1,1,1,1,1,1,1,1,1,1,1,1,1,1,1,1,0,0,0,0,0,0,0,1,1,1,1,1,1,0,0,0,0,0,1,1,1,1,1,1,1,1,1,1,1,1,1,1,1,1,1,1,1,1,0,0,0,0,0,0,0,0,0,0,0,1,1,1,0,0,0,0,0,0,0,0,0,0,0,1,1,1,1,1,1,1,1,1,1,0,0,0,0,0,0,0,0,1,1,1,0,0,0,0,0,0,0,0,1,1,0,0,0,0,0,0,0,0,0,0,0,0,1,1,1,1,0,0,0,0,1,1,1,1,1,1,1,1,1,1,1,1,1,1,0,0,0,0,0,0,0,0,1,1,1,1,1,1,1,1,1,1,1,1,1,1,1,1,1,;
208,208,208,208,208,208,208,208,208,208,208,208,208,208,208,208,208,208,208,208,208,208,208,208,208,208,208,208,208,208,208,208,208,208,208,208,208,208,208,208,208,208,208,208,208,208,208,208,208,208,208,208,208,208,208,208,208,208,208,208,208,208,208,208,208,208,208,208,208,208,208,208,208,208,208,208,208,208,208,208,208,208,208,208,208,208,208,208,208,208,208,208,208,208,208,208,208,208,208,208,208,208,208,208,208,208,208,208,208,208,208,208,208,208,208,208,208,208,208,216,216,216,216,216,208,216,216,216,216,216,216,216,216,216,216,216,216,216,216,216,216,216,216,216,216,216,216,216,216,216,216,216,216,216,216,211,216,216,216,216,216,216,216,216,216,216,216,216,216,216,216,216,216,216,216,216,216,216,216,216,216,216,219,219,216,216,216,216,219,216,219,219,219,216,216,216,216,216,211,211,216,216,216,216,216,216,216,216,216,216,216,216,216,219,216,219,219,219,216,216,214,214,216,216,216,216,216,216,216,214,216,216,216,216,216,216,216,216,216,216,216,216,216,216,216,216,216,216,216,216,216,216,216,216,211,216,216,216,216,216,216,216,216,216,216,214,216,216,214,216,214,214,216,211,211,216,216,216,216,216,214,216,216,216,216,216,216,216,216,216,216,216,216,211,216,214,216,216,216,216,216,216,216,216,216,216,216,216,216,216,216,216,216,216,216,216,216,216,216,216,216,208,216,216,216,216,216,216,216,216,216,211,216,214,216,216,216,211,216,219,219,219,219,219,208,208,208,208,208,208,208,214,214,211,208,208,208,208,208,208,208,208,208,219,208,208,208,208,208,208,208,208,208,208,208,208,213,213,213,213,208,213,208,208,208,208,208,208,208,208,208,208,208,208,208,208,208,208,208,208,208,208,208,208,208,208,208,219,219,219,219,219,219,211,211,211,219,208,208,208,208,208,208,208,208,211,214,214,208,208,208,208,208,208,208,208,214,211,208,208,208,208,208,208,208,208,208,208,208,208,219,219,219,219,208,208,208,208,211,211,211,214,214,214,214,208,208,208,208,208,208,208,208,208,208,208,208,208,208,208,211,211,214,214,214,208,208,208,208,208,208,208,208,208,208,208,208,;
0,0,0,0,0,0,0,0,0,0,0,0,0,0,0,0,0,0,0,0,0,0,0,0,0,0,0,0,0,0,0,0,0,0,0,0,0,0,0,0,0,0,0,0,0,0,0,0,0,0,0,0,0,0,0,0,0,0,0,0,0,0,0,0,0,0,0,0,0,0,0,0,0,0,0,0,0,0,0,0,0,0,0,0,0,0,0,0,0,0,0,0,0,0,0,0,0,0,0,0,0,0,0,0,0,0,0,0,0,0,0,0,0,0,0,0,0,0,0,5,5,5,5,5,0,5,5,5,5,5,5,5,5,5,5,5,5,5,5,5,5,5,5,5,5,5,5,5,5,5,5,5,5,5,5,3,5,5,5,5,5,5,5,5,5,5,5,5,5,5,5,5,5,5,5,5,0,5,5,5,5,5,3,3,5,5,5,5,3,5,3,3,3,5,5,5,5,5,3,3,5,5,5,5,5,5,5,5,5,5,5,5,5,3,5,3,3,3,5,5,3,3,5,5,5,5,5,5,5,3,5,5,5,5,5,5,5,5,5,5,5,5,5,5,5,5,5,5,5,5,5,5,5,5,3,5,5,5,5,5,5,5,5,5,5,3,5,5,3,5,3,3,5,3,3,5,5,5,5,5,3,5,5,5,5,5,5,5,5,5,5,5,5,3,5,3,5,5,5,5,5,5,5,5,5,5,5,5,5,5,5,5,5,5,5,5,5,5,5,5,5,0,5,5,5,5,5,5,5,5,5,3,5,3,5,5,5,3,5,3,3,0,3,0,0,0,0,0,0,0,0,3,3,3,0,0,0,0,0,0,0,0,0,0,0,0,0,0,0,0,0,0,0,0,0,0,3,3,3,3,3,3,0,0,0,0,0,0,0,0,0,0,0,0,0,0,0,0,0,0,0,0,0,0,0,0,0,3,3,3,3,3,3,3,3,3,3,0,0,0,0,0,0,0,0,3,3,3,0,0,0,0,0,0,0,0,3,3,0,0,0,0,0,0,0,0,0,0,0,0,4,4,4,4,0,0,0,0,3,3,3,3,3,3,3,0,0,0,0,0,0,0,0,0,0,0,0,0,0,0,3,3,3,3,3,0,0,0,0,0,0,0,0,0,0,0,0,;
0"",0"",0"",0"",0"",0"",0"",0"",0"",0"",0"",0"",0"",0"",0"",0"",0"",0"",0"",0"",0"",0"",0"",0"",0"",0"",0"",0"",0"",0"",0"",0"",0"",0"",0"",0"",0"",0"",0"",0"",0"",0"",0"",0"",0"",0"",0"",0"",0"",0"",0"",0"",0"",0"",0"",0"",0"",0"",0"",0"",0"",0"",0"",0"",0"",0"",0"",0"",0"",0"",0"",0"",0"",0"",0"",0"",0"",0"",0"",0"",0"",0"",0"",0"",0"",0"",0"",0"",0"",0"",0"",0"",0"",0"",0"",0"",0"",0"",0"",0"",0"",0"",0"",0"",0"",0"",0"",0"",0"",0"",0"",0"",0"",0"",0"",0"",0"",0"",0"",0"",0"",0"",0"",0"",0"",0"",0"",0"",0"",0"",0"",0"",0"",0"",0"",0"",0"",0"",0"",0"",0"",0"",0"",0"",0"",0"",0"",0"",0"",0"",0"",0"",0"",0"",0"",0"",0"",0"",0"",0"",0"",0"",0"",0"",0"",0"",0"",0"",0"",0"",0"",0"",0"",0"",0"",0"",0"",0"",0"",0"",0"",0"",0"",0"",0"",0"",0"",0"",0"",0"",0"",0"",0"",0"",0"",0"",0"",0"",0"",0"",0"",0"",0"",0"",0"",0"",0"",0"",0"",0"",0"",0"",0"",0"",0"",0"",0"",0"",0"",0"",0"",0"",0"",0"",0"",0"",0"",0"",0"",0"",0"",0"",0"",0"",0"",0"",0"",0"",0"",0"",0"",0"",0"",0"",0"",0"",0"",0"",0"",0"",0"",0"",0"",0"",0"",0"",0"",0"",0"",0"",0"",0"",0"",0"",0"",0"",0"",0"",0"",0"",0"",0"",0"",0"",0"",0"",0"",0"",0"",0"",0"",0"",0"",0"",0"",0"",0"",0"",0"",0"",0"",0"",0"",0"",0"",0"",0"",0"",0"",0"",0"",0"",0"",0"",0"",0"",0"",0"",0"",0"",0"",0"",0"",0"",0"",0"",0"",0"",0"",0"",0"",0"",0"",0"",0"",0"",0"",0"",0"",0"",0"",0"",0"",0"",0"",0"",0"",0"",0"",0"",0"",0"",0"",0"",0"",0"",0"",0"",0"",0"",0"",0"",0"",0"",0"",0"",0"",0"",0"",0"",0"",0"",0"",0"",0"",0"",0"",0"",0"",0"",0"",0"",0"",0"",0"",0"",0"",0"",0"",0"",0"",0"",0"",0"",0"",0"",0"",0"",0"",0"",0"",0"",0"",0"",0"",0"",0"",0"",0"",0"",0"",0"",0"",0"",0"",0"",0"",0"",0"",0"",0"",0"",0"",0"",0"",0"",0"",0"",0"",0"",0"",0"",0"",0"",0"",0"",0"",0"",0"",0"",0"",0"",0"",0"",0"",0"",0"",0"",0"",0"",0"",0"",0"",0"",0"",0"",0"",0"",0"",0"",0"",0"",0"",0"",0"",0"",0"",0"",0"",0"",0"",0"",0"",0"",0"",0"",0"",0"",0"",0"",0"",0"",0"",0"",0"",0"",0"",0"",0"",0"",0"",0"",0"",0"",0"",0"",0"",0"",0"",0"",0"",0"",0"",0"",0"",0"",0"",;
2,0,2,2,2,2,2,1,1,1,1,3,3,3,2,2,2,2,2,2,2,2,2,2,2,2,2,3,3,3,5,5,5,5,5,5,4,4,4,4,4,4,4,4,5,5,5,5,5,5,;
1832,1901,1835,1722,1939,1372,1320,3075,2968,3218,3071,2459,2037,950,2669,2544,770,731,1986,1548,737,882,804,2439,3581,3206,3021,1165,494,3185,2278,2624,2573,2526,2470,2362,2312,2378,1910,2030,2270,2432,1978,1856,848,763,697,660,590,529,;
437,1302,1276,1180,1277,1309,1276,1034,925,1093,851,1436,975,1372,2218,2047,2176,2065,883,709,1002,997,1115,2539,1869,1779,1925,358,1815,2143,881,1063,1019,946,855,852,2527,2555,2212,2241,2486,2572,2245,2186,616,638,649,656,671,680,;
1.0,1.0,1.0,1.0,1.0,1.0,1.0,1.0,1.0,1.0,;
1.0,1.0,1.0,1.0,1.0,1.0,1.0,1.0,1.0,1.0,;
4,0,2,1,5,7,0,0,0,0,;
60,100,70,98,100,100,1,1,1,1,;
1,1,1,1,1,1,1,1,1,1,;
0,0,0,0,100,100,100,100,100,100,;
13,9,1,13,12,0,0,0,0,0,;
4,1,4,4,3,1,1,1,1,1,;
10,5,5,20,50,50,1,1,1,1,;
22,100,35,40,100,100,1,1,1,1,;
640,45,5,0,10,10,0,0,0,0,;
1,1,1,1,11,45,500,500,500,500,;
0,20,50,20,20,1,0,0,0,0,;
1,1,1,1,1,1,1,1,1,1,;
1,10,5,10,1,1,1,1,1,1,;
1,5,1,5,1,1,1,1,1,1,;
1,4,4,2,1,1,1,1,1,1,;
22,100,20,67,100,100,1,1,1,1,;
13,9,1,12,236,9,1,1,1,1,;
3,0,4,2,2,2,0,0,0,0,;
0,0,0,1,0,0,0,0,0,0,;
0,0,0,5,0,0,0,0,0,0,;
0,0,0,0,0,0,0,0,0,0,;
1208;
2081;
4;
7;
0;
0;
0,1,;
0;
0,1,;
24,0,0,0,0,0,0,0,0,0,0,0,0,0,0,0,0,0,0,0,0,0,0,0,0,;
179,0,0,0,0,0,0,0,0,0,0,0,0,0,0,0,0,0,0,0,0,0,0,0,0,;
216,0,0,0,0,0,0,0,0,0,0,0,0,0,0,0,0,0,0,0,0,0,0,0,0,;
